#################
#E     B        #
#  B      BEEE  #
########        #
#               #
#      #        #
#               #
#  WW   F   BB  #
#               #
#        #      #
#               #
#        ########
#  EEEW      W  #
#        W     E#
#################